"samplename","num_total_snv","num_Clusters","num_clonal_snv","num_subclonal_snv","Subclonal_fraction","cancer_type"
"00c27940-c623-11e3-bf01-24c6515278c0",16027,1,16027,0,0,"LIRI"
"01dc6872-c623-11e3-bf01-24c6515278c0",9341,2,8268,1073,0.114869928,"LIRI"
"030695f6-c623-11e3-bf01-24c6515278c0",12773,2,9451,3322,0.260079856,"LIRI"
"041e3b42-c623-11e3-bf01-24c6515278c0",7727,2,7257,470,0.060825676,"LIRI"
"062e96d4-c623-11e3-bf01-24c6515278c0",10220,1,10220,0,0,"LIRI"
"072f4146-c623-11e3-bf01-24c6515278c0",9177,1,9177,0,0,"LIRI"
"0831e45e-c623-11e3-bf01-24c6515278c0",19983,2,18919,1064,0.053245258,"LIRI"
"0a9c9db0-c623-11e3-bf01-24c6515278c0",10567,1,10567,0,0,"LIRI"
"0be08326-c623-11e3-bf01-24c6515278c0",13122,1,13122,0,0,"LIRI"
"0cdbabf2-c623-11e3-bf01-24c6515278c0",5651,1,5651,0,0,"LIRI"
"0dd39eca-c623-11e3-bf01-24c6515278c0",8413,2,7833,580,0.068940925,"LIRI"
"0eeafcd6-c623-11e3-bf01-24c6515278c0",18360,2,15533,2827,0.153976035,"LIRI"
"10136472-c623-11e3-bf01-24c6515278c0",3210,1,3210,0,0,"LIRI"
"10cb8ac6-c622-11e3-bf01-24c6515278c0",21624,2,20345,1279,0.059147244,"LIRI"
"10db2142-c623-11e3-bf01-24c6515278c0",10200,3,8391,1809,0.177352941,"LIRI"
"1295947c-c623-11e3-bf01-24c6515278c0",31285,2,29574,1711,0.054690746,"LIRI"
"13bd2b30-c623-11e3-bf01-24c6515278c0",4917,1,4917,0,0,"LIRI"
"15895218-c623-11e3-bf01-24c6515278c0",13479,2,12098,1381,0.102455672,"LIRI"
"15fd8dc8-c622-11e3-bf01-24c6515278c0",14214,2,13455,759,0.053398058,"LIRI"
"17de5b12-c623-11e3-bf01-24c6515278c0",13021,3,10154,2867,0.220182782,"LIRI"
"18f5e75e-c623-11e3-bf01-24c6515278c0",4814,3,3330,1484,0.308267553,"LIRI"
"19fe27d8-c623-11e3-bf01-24c6515278c0",8604,2,7965,639,0.074267782,"LIRI"
"1b06afe2-c623-11e3-bf01-24c6515278c0",7138,1,7138,0,0,"LIRI"
"1c10ab52-01a3-11e4-8395-af1f6b7ba88c",10053,2,9337,716,0.071222521,"LIRI"
"1c1c6494-c623-11e3-bf01-24c6515278c0",9014,1,9014,0,0,"LIRI"
"1dbdbb2c-c623-11e3-bf01-24c6515278c0",22078,1,22078,0,0,"LIRI"
"1df8939c-c622-11e3-bf01-24c6515278c0",9463,2,8919,544,0.057487055,"LIRI"
"1ea7e01c-c623-11e3-bf01-24c6515278c0",11384,1,11384,0,0,"LIRI"
"1fd69adc-c623-11e3-bf01-24c6515278c0",4442,2,3856,586,0.131922557,"LIRI"
"2109e1d4-c623-11e3-bf01-24c6515278c0",3374,1,3374,0,0,"LIRI"
"221d0290-c623-11e3-bf01-24c6515278c0",13185,2,11690,1495,0.113386424,"LIRI"
"2316ee90-c623-11e3-bf01-24c6515278c0",585,2,553,32,0.054700855,"LIRI"
"23eb72d8-c622-11e3-bf01-24c6515278c0",16416,2,15576,840,0.051169591,"LIRI"
"2468e58c-c623-11e3-bf01-24c6515278c0",13377,1,13377,0,0,"LIRI"
"2572b0bc-c622-11e3-bf01-24c6515278c0",7864,1,7864,0,0,"LIRI"
"2584b428-c623-11e3-bf01-24c6515278c0",8297,1,8297,0,0,"LIRI"
"26de406e-c623-11e3-bf01-24c6515278c0",16041,2,15138,903,0.056293249,"LIRI"
"27fcccdc-c622-11e3-bf01-24c6515278c0",19724,2,18533,1191,0.060383289,"LIRI"
"2828e5e6-c623-11e3-bf01-24c6515278c0",20666,2,16359,4307,0.208409949,"LIRI"
"295aac88-c623-11e3-bf01-24c6515278c0",10555,2,10010,545,0.051634297,"LIRI"
"2b569b88-c622-11e3-bf01-24c6515278c0",21601,1,21601,0,0,"LIRI"
"2bd56bba-c623-11e3-bf01-24c6515278c0",7369,1,7369,0,0,"LIRI"
"2d0e4b82-c623-11e3-bf01-24c6515278c0",13498,2,12715,783,0.058008594,"LIRI"
"2e0bbaf6-c623-11e3-bf01-24c6515278c0",4579,2,3818,761,0.166193492,"LIRI"
"2ecd8358-c622-11e3-bf01-24c6515278c0",11711,2,10793,918,0.07838784,"LIRI"
"2f149d78-c623-11e3-bf01-24c6515278c0",11075,2,10493,582,0.05255079,"LIRI"
"30a8f292-c623-11e3-bf01-24c6515278c0",8549,3,4259,4290,0.501813078,"LIRI"
"31bcfd64-c622-11e3-bf01-24c6515278c0",8039,2,7313,726,0.09030974,"LIRI"
"31c0c8f8-c623-11e3-bf01-24c6515278c0",12557,2,10128,2429,0.193437923,"LIRI"
"32be40fa-c623-11e3-bf01-24c6515278c0",8800,2,8354,446,0.050681818,"LIRI"
"33a8693c-c623-11e3-bf01-24c6515278c0",14364,1,14364,0,0,"LIRI"
"34030a28-c622-11e3-bf01-24c6515278c0",9590,2,8258,1332,0.138894682,"LIRI"
"34c24482-c623-11e3-bf01-24c6515278c0",8525,2,7973,552,0.064750733,"LIRI"
"35cca3b8-c623-11e3-bf01-24c6515278c0",15070,2,9343,5727,0.380026543,"LIRI"
"35e33a7a-c622-11e3-bf01-24c6515278c0",5680,1,5680,0,0,"LIRI"
"36d9c1aa-c623-11e3-bf01-24c6515278c0",6300,1,6300,0,0,"LIRI"
"380593d8-c623-11e3-bf01-24c6515278c0",19708,1,19708,0,0,"LIRI"
"38d8e626-c622-11e3-bf01-24c6515278c0",15275,2,14301,974,0.063764321,"LIRI"
"39458b0e-c623-11e3-bf01-24c6515278c0",1541,1,1541,0,0,"LIRI"
"3a49a936-c623-11e3-bf01-24c6515278c0",10164,2,8854,1310,0.128886265,"LIRI"
"3b41cb48-c623-11e3-bf01-24c6515278c0",7241,3,5326,1915,0.264466234,"LIRI"
"3c30b10e-c623-11e3-bf01-24c6515278c0",9055,1,9055,0,0,"LIRI"
"3c78970e-c622-11e3-bf01-24c6515278c0",10841,1,10841,0,0,"LIRI"
"3d400522-c623-11e3-bf01-24c6515278c0",10136,2,9510,626,0.061760063,"LIRI"
"3e2a85d0-c622-11e3-bf01-24c6515278c0",6506,1,6506,0,0,"LIRI"
"3e68233a-c623-11e3-bf01-24c6515278c0",7454,2,6994,460,0.061711833,"LIRI"
"3f99ae0e-c623-11e3-bf01-24c6515278c0",18027,2,12213,5814,0.322516226,"LIRI"
"3faeb03e-c622-11e3-bf01-24c6515278c0",18894,2,17928,966,0.051127342,"LIRI"
"40b1e928-c623-11e3-bf01-24c6515278c0",17428,2,16350,1078,0.061854487,"LIRI"
"41de507a-c623-11e3-bf01-24c6515278c0",5397,2,4824,573,0.106170094,"LIRI"
"4255582e-c622-11e3-bf01-24c6515278c0",5264,2,4762,502,0.095364742,"LIRI"
"42e92d78-c623-11e3-bf01-24c6515278c0",16499,2,15321,1178,0.071398267,"LIRI"
"43dadc68-c623-11e3-bf01-24c6515278c0",11247,4,2527,8720,0.775317863,"LIRI"
"446437de-c622-11e3-bf01-24c6515278c0",17830,2,16625,1205,0.067582726,"LIRI"
"44e4f08a-c623-11e3-bf01-24c6515278c0",9894,1,9894,0,0,"LIRI"
"45aedf22-c622-11e3-bf01-24c6515278c0",12845,2,11816,1029,0.080108992,"LIRI"
"47050918-c623-11e3-bf01-24c6515278c0",11838,3,10168,1670,0.141071127,"LIRI"
"47d77750-c622-11e3-bf01-24c6515278c0",20999,1,20999,0,0,"LIRI"
"48624a82-c623-11e3-bf01-24c6515278c0",19340,1,19340,0,0,"LIRI"
"49795e42-c623-11e3-bf01-24c6515278c0",22206,2,21090,1116,0.050256687,"LIRI"
"4a703d3e-c623-11e3-bf01-24c6515278c0",16757,2,14425,2332,0.139165722,"LIRI"
"4b8943be-c623-11e3-bf01-24c6515278c0",14126,1,14126,0,0,"LIRI"
"4c183106-c622-11e3-bf01-24c6515278c0",6135,2,4822,1313,0.21401793,"LIRI"
"4c8afa82-c623-11e3-bf01-24c6515278c0",12072,2,10979,1093,0.090540093,"LIRI"
"4dac9498-c623-11e3-bf01-24c6515278c0",10342,2,9604,738,0.071359505,"LIRI"
"4ed52e0c-c623-11e3-bf01-24c6515278c0",6810,1,6810,0,0,"LIRI"
"4f6f48bc-c622-11e3-bf01-24c6515278c0",11219,1,11219,0,0,"LIRI"
"4fdc8980-c623-11e3-bf01-24c6515278c0",11504,2,10744,760,0.066063978,"LIRI"
"50eb58ba-c623-11e3-bf01-24c6515278c0",12933,2,12243,690,0.053351891,"LIRI"
"51800588-c622-11e3-bf01-24c6515278c0",6055,2,5670,385,0.063583815,"LIRI"
"520b8ab2-c623-11e3-bf01-24c6515278c0",13604,2,12807,797,0.05858571,"LIRI"
"52d8ccfc-c623-11e3-bf01-24c6515278c0",15396,2,14601,795,0.051636789,"LIRI"
"532259b8-c622-11e3-bf01-24c6515278c0",27319,2,25641,1678,0.061422453,"LIRI"
"53df19a8-c623-11e3-bf01-24c6515278c0",16010,2,15185,825,0.051530294,"LIRI"
"54354d24-c622-11e3-bf01-24c6515278c0",22677,2,20795,1882,0.082991577,"LIRI"
"54cfd4b0-c623-11e3-bf01-24c6515278c0",14531,2,13654,877,0.060353727,"LIRI"
"55e5497a-c623-11e3-bf01-24c6515278c0",17313,2,16034,1279,0.073875123,"LIRI"
"56c846d6-c622-11e3-bf01-24c6515278c0",10566,3,7566,3000,0.283929585,"LIRI"
"56d4ea48-c623-11e3-bf01-24c6515278c0",18196,2,17154,1042,0.057265333,"LIRI"
"5808f774-c623-11e3-bf01-24c6515278c0",8143,1,8143,0,0,"LIRI"
"58f4ff52-c623-11e3-bf01-24c6515278c0",11542,2,10929,613,0.053110379,"LIRI"
"59632e7e-c622-11e3-bf01-24c6515278c0",14540,2,13737,803,0.05522696,"LIRI"
"5a51a6fc-c623-11e3-bf01-24c6515278c0",9086,1,9086,0,0,"LIRI"
"5b178f44-c622-11e3-bf01-24c6515278c0",7359,2,6670,689,0.093626851,"LIRI"
"5bb37ffc-c623-11e3-bf01-24c6515278c0",17737,2,16779,958,0.054011389,"LIRI"
"5c9b8a2c-c623-11e3-bf01-24c6515278c0",3510,3,2671,839,0.239031339,"LIRI"
"5cf21488-c622-11e3-bf01-24c6515278c0",11698,2,11006,692,0.059155411,"LIRI"
"5dce221a-c623-11e3-bf01-24c6515278c0",6388,2,5777,611,0.09564809,"LIRI"
"5e9c69d2-c622-11e3-bf01-24c6515278c0",5706,1,5706,0,0,"LIRI"
"5eddfb26-c623-11e3-bf01-24c6515278c0",10308,1,10308,0,0,"LIRI"
"6012cb02-c623-11e3-bf01-24c6515278c0",5384,1,5384,0,0,"LIRI"
"60f81dba-c623-11e3-bf01-24c6515278c0",5578,2,3643,1935,0.34689853,"LIRI"
"6172ca02-c622-11e3-bf01-24c6515278c0",5871,3,4512,1359,0.23147675,"LIRI"
"627823ec-c623-11e3-bf01-24c6515278c0",10566,2,9988,578,0.054703767,"LIRI"
"632f3eb0-c623-11e3-bf01-24c6515278c0",17412,1,17412,0,0,"LIRI"
"63fef3fe-c622-11e3-bf01-24c6515278c0",30326,2,25376,4950,0.163226274,"LIRI"
"64b80154-c623-11e3-bf01-24c6515278c0",15402,3,11919,3483,0.226139462,"LIRI"
"6527aa5a-c622-11e3-bf01-24c6515278c0",7321,1,7321,0,0,"LIRI"
"65f702b8-c623-11e3-bf01-24c6515278c0",2203,1,2203,0,0,"LIRI"
"6622f932-c622-11e3-bf01-24c6515278c0",6462,2,5650,812,0.125657691,"LIRI"
"67189cd8-c623-11e3-bf01-24c6515278c0",6130,2,5484,646,0.105383361,"LIRI"
"674819dc-c622-11e3-bf01-24c6515278c0",8169,2,6105,2064,0.252662505,"LIRI"
"68054218-c623-11e3-bf01-24c6515278c0",7034,2,6650,384,0.054591982,"LIRI"
"690e481c-c623-11e3-bf01-24c6515278c0",17008,2,16049,959,0.05638523,"LIRI"
"69f37546-c622-11e3-bf01-24c6515278c0",22039,2,20819,1220,0.055356414,"LIRI"
"6a129b50-c623-11e3-bf01-24c6515278c0",15258,2,14406,852,0.05583956,"LIRI"
"6baee028-c622-11e3-bf01-24c6515278c0",8808,2,8204,604,0.068574024,"LIRI"
"6c306cbe-c623-11e3-bf01-24c6515278c0",19783,2,18206,1577,0.079714907,"LIRI"
"6ce66be0-c623-11e3-bf01-24c6515278c0",7428,1,7428,0,0,"LIRI"
"6d9d7ffc-c622-11e3-bf01-24c6515278c0",12280,1,12280,0,0,"LIRI"
"6e26f98e-c623-11e3-bf01-24c6515278c0",6701,1,6701,0,0,"LIRI"
"6ec4456e-c622-11e3-bf01-24c6515278c0",8919,2,8375,544,0.060993385,"LIRI"
"6f395380-c623-11e3-bf01-24c6515278c0",7874,1,7874,0,0,"LIRI"
"7034e5f6-c623-11e3-bf01-24c6515278c0",1411,1,1411,0,0,"LIRI"
"70c2f91e-c622-11e3-bf01-24c6515278c0",10035,2,9189,846,0.084304933,"LIRI"
"712e5f3c-c623-11e3-bf01-24c6515278c0",8890,1,8890,0,0,"LIRI"
"7260f57c-c623-11e3-bf01-24c6515278c0",9112,2,8405,707,0.077589991,"LIRI"
"72c22a8c-c622-11e3-bf01-24c6515278c0",12414,2,11470,944,0.076043177,"LIRI"
"73afad06-c623-11e3-bf01-24c6515278c0",15868,2,14496,1372,0.086463322,"LIRI"
"74ec279a-c622-11e3-bf01-24c6515278c0",16135,1,16135,0,0,"LIRI"
"7512b38c-c623-11e3-bf01-24c6515278c0",3251,1,3251,0,0,"LIRI"
"760881cc-c623-11e3-bf01-24c6515278c0",191303,2,183590,7713,0.040318239,"LIRI"
"764ded9e-c622-11e3-bf01-24c6515278c0",15958,2,14918,1040,0.065171074,"LIRI"
"7789ef18-c623-11e3-bf01-24c6515278c0",9714,1,9714,0,0,"LIRI"
"78bc2608-c623-11e3-bf01-24c6515278c0",2427,2,2254,173,0.071281417,"LIRI"
"78bc4dfa-c622-11e3-bf01-24c6515278c0",4256,1,4256,0,0,"LIRI"
"79b23f34-c623-11e3-bf01-24c6515278c0",3771,3,3117,654,0.173428799,"LIRI"
"7ae510f8-c622-11e3-bf01-24c6515278c0",11110,2,10250,860,0.077407741,"LIRI"
"7ae872a6-c623-11e3-bf01-24c6515278c0",3257,1,3257,0,0,"LIRI"
"7bdcb78a-c623-11e3-bf01-24c6515278c0",3654,2,1030,2624,0.718117132,"LIRI"
"7c405ca0-c622-11e3-bf01-24c6515278c0",13003,2,11725,1278,0.098285011,"LIRI"
"7cd7fe38-c623-11e3-bf01-24c6515278c0",6096,1,6096,0,0,"LIRI"
"7d38018a-c622-11e3-bf01-24c6515278c0",15257,2,14453,804,0.052697123,"LIRI"
"7df3a542-c623-11e3-bf01-24c6515278c0",11236,3,3608,7628,0.678889284,"LIRI"
"7eac4710-c622-11e3-bf01-24c6515278c0",17211,2,15826,1385,0.080471791,"LIRI"
"7f795952-c623-11e3-bf01-24c6515278c0",17191,2,16225,966,0.056192194,"LIRI"
"7fba5aac-c622-11e3-bf01-24c6515278c0",9760,1,9760,0,0,"LIRI"
"80ab6c08-c622-11e3-bf01-24c6515278c0",2411,2,1918,493,0.204479469,"LIRI"
"819b4304-c622-11e3-bf01-24c6515278c0",19123,2,17172,1951,0.102023741,"LIRI"
"82aefe8e-c622-11e3-bf01-24c6515278c0",11244,2,10679,565,0.050249022,"LIRI"
"83d57c5c-c622-11e3-bf01-24c6515278c0",8315,2,7734,581,0.069873722,"LIRI"
"850389d4-c622-11e3-bf01-24c6515278c0",17478,3,15073,2405,0.137601556,"LIRI"
"8659a35e-c622-11e3-bf01-24c6515278c0",8994,2,7012,1982,0.220369135,"LIRI"
"87671312-c622-11e3-bf01-24c6515278c0",13966,2,13029,937,0.067091508,"LIRI"
"88d82a42-c622-11e3-bf01-24c6515278c0",10602,2,9855,747,0.070458404,"LIRI"
"8a6d6b2e-c622-11e3-bf01-24c6515278c0",8315,1,8315,0,0,"LIRI"
"8c5f9574-c622-11e3-bf01-24c6515278c0",9845,2,9307,538,0.054647029,"LIRI"
"8d7592e2-c622-11e3-bf01-24c6515278c0",11562,2,10438,1124,0.097215015,"LIRI"
"8eb90ea4-c622-11e3-bf01-24c6515278c0",7805,2,7240,565,0.072389494,"LIRI"
"8fd5e62c-c622-11e3-bf01-24c6515278c0",19802,1,19802,0,0,"LIRI"
"917564e4-c622-11e3-bf01-24c6515278c0",2579,3,1789,790,0.306320279,"LIRI"
"9321341c-c622-11e3-bf01-24c6515278c0",6033,2,5140,893,0.148019228,"LIRI"
"94431626-c622-11e3-bf01-24c6515278c0",15750,1,15750,0,0,"LIRI"
"9563a264-c622-11e3-bf01-24c6515278c0",4835,2,3501,1334,0.27590486,"LIRI"
"96abdbc8-c622-11e3-bf01-24c6515278c0",14454,2,9627,4827,0.333955998,"LIRI"
"97a6f44a-c622-11e3-bf01-24c6515278c0",2400,2,1397,1003,0.417916667,"LIRI"
"98d27916-c622-11e3-bf01-24c6515278c0",26922,3,20455,6467,0.240212466,"LIRI"
"99bdc3da-c622-11e3-bf01-24c6515278c0",13104,1,13104,0,0,"LIRI"
"9aac83e4-c622-11e3-bf01-24c6515278c0",10887,2,9441,1446,0.132818958,"LIRI"
"9ba2c970-c622-11e3-bf01-24c6515278c0",15773,3,12998,2775,0.175933557,"LIRI"
"9cb80280-c622-11e3-bf01-24c6515278c0",13681,2,11759,1922,0.140486807,"LIRI"
"9db994a0-c622-11e3-bf01-24c6515278c0",14704,3,4882,9822,0.667981502,"LIRI"
"9ec31146-c622-11e3-bf01-24c6515278c0",14561,1,14561,0,0,"LIRI"
"9fba5db6-c622-11e3-bf01-24c6515278c0",12585,2,11554,1031,0.081922924,"LIRI"
"a1a75f66-c622-11e3-bf01-24c6515278c0",14520,1,14520,0,0,"LIRI"
"a2a67c8a-c622-11e3-bf01-24c6515278c0",10959,1,10959,0,0,"LIRI"
"a3914a6c-c622-11e3-bf01-24c6515278c0",16413,1,16413,0,0,"LIRI"
"a4ca18dc-c622-11e3-bf01-24c6515278c0",16087,2,14312,1775,0.11033754,"LIRI"
"a612b654-c622-11e3-bf01-24c6515278c0",9189,1,9189,0,0,"LIRI"
"a7314730-c622-11e3-bf01-24c6515278c0",13728,2,13012,716,0.052156177,"LIRI"
"a846f5e8-c622-11e3-bf01-24c6515278c0",11061,2,10003,1058,0.095651388,"LIRI"
"a94d63fa-c622-11e3-bf01-24c6515278c0",12114,2,11187,927,0.076523031,"LIRI"
"aabddb20-c622-11e3-bf01-24c6515278c0",5591,2,4166,1425,0.254873904,"LIRI"
"abbbe65c-c622-11e3-bf01-24c6515278c0",13032,2,12218,814,0.062461633,"LIRI"
"adfbba82-c622-11e3-bf01-24c6515278c0",9011,2,8486,525,0.058262124,"LIRI"
"af2cbdb6-c622-11e3-bf01-24c6515278c0",7780,2,5852,1928,0.24781491,"LIRI"
"b070af2a-c622-11e3-bf01-24c6515278c0",8392,1,8392,0,0,"LIRI"
"b1f19de6-c622-11e3-bf01-24c6515278c0",7752,2,7213,539,0.069530444,"LIRI"
"b32449c0-c622-11e3-bf01-24c6515278c0",10659,2,10093,566,0.053100666,"LIRI"
"b421b9ca-c622-11e3-bf01-24c6515278c0",17418,2,16517,901,0.051728097,"LIRI"
"b55751c4-c622-11e3-bf01-24c6515278c0",7303,2,6720,583,0.079830207,"LIRI"
"b67208c4-c622-11e3-bf01-24c6515278c0",6710,1,6710,0,0,"LIRI"
"b77543e4-c622-11e3-bf01-24c6515278c0",10307,2,8513,1794,0.174056466,"LIRI"
"b86655a4-c622-11e3-bf01-24c6515278c0",3397,2,3146,251,0.073888725,"LIRI"
"b994762c-c622-11e3-bf01-24c6515278c0",18490,1,18490,0,0,"LIRI"
"ba940092-c622-11e3-bf01-24c6515278c0",12306,2,11690,616,0.050056883,"LIRI"
"bba106ce-c622-11e3-bf01-24c6515278c0",11299,1,11299,0,0,"LIRI"
"bcc74a5e-c622-11e3-bf01-24c6515278c0",8717,1,8717,0,0,"LIRI"
"bdeeb1a6-c622-11e3-bf01-24c6515278c0",6323,1,6323,0,0,"LIRI"
"bef21282-c622-11e3-bf01-24c6515278c0",13557,2,12853,704,0.051928893,"LIRI"
"c021b61c-c622-11e3-bf01-24c6515278c0",7686,1,7686,0,0,"LIRI"
"c158ac2a-c622-11e3-bf01-24c6515278c0",1939,1,1939,0,0,"LIRI"
"c271b7d2-c622-11e3-bf01-24c6515278c0",8706,2,8152,554,0.063634275,"LIRI"
"c488a170-c622-11e3-bf01-24c6515278c0",6815,2,6171,644,0.094497432,"LIRI"
"c5ad7238-c622-11e3-bf01-24c6515278c0",15588,2,12685,2903,0.186233,"LIRI"
"c6bb32f0-c622-11e3-bf01-24c6515278c0",41606,2,35897,5709,0.137215786,"LIRI"
"c7d798b8-c622-11e3-bf01-24c6515278c0",12088,2,11104,984,0.081403044,"LIRI"
"c906a13e-c622-11e3-bf01-24c6515278c0",6674,2,5882,792,0.118669464,"LIRI"
"ca5ded1c-c622-11e3-bf01-24c6515278c0",9912,2,9408,504,0.050847458,"LIRI"
"cb86fbb6-c622-11e3-bf01-24c6515278c0",8086,2,7617,469,0.058001484,"LIRI"
"cc792058-c622-11e3-bf01-24c6515278c0",10248,2,8291,1957,0.190964091,"LIRI"
"cdcc04fc-c622-11e3-bf01-24c6515278c0",16427,2,15441,986,0.060023133,"LIRI"
"cf2d34c4-c622-11e3-bf01-24c6515278c0",21149,2,18448,2701,0.127712894,"LIRI"
"d0469256-c622-11e3-bf01-24c6515278c0",18092,2,16494,1598,0.088326332,"LIRI"
"d182b67c-c622-11e3-bf01-24c6515278c0",5141,2,4777,364,0.070803346,"LIRI"
"d2b7bb0a-c622-11e3-bf01-24c6515278c0",8633,3,6741,1892,0.219159041,"LIRI"
"d3ad5b5a-c622-11e3-bf01-24c6515278c0",9342,1,9342,0,0,"LIRI"
"d4c9e5c6-c622-11e3-bf01-24c6515278c0",11926,2,11221,705,0.05911454,"LIRI"
"d60f880a-c622-11e3-bf01-24c6515278c0",17372,2,16280,1092,0.062859774,"LIRI"
"d7578910-c622-11e3-bf01-24c6515278c0",12810,2,12087,723,0.056440281,"LIRI"
"d876d576-c622-11e3-bf01-24c6515278c0",9529,1,9529,0,0,"LIRI"
"da5b9926-c622-11e3-bf01-24c6515278c0",5135,2,3072,2063,0.401752678,"LIRI"
"dbfa4e8a-c622-11e3-bf01-24c6515278c0",10194,1,10194,0,0,"LIRI"
"dd2e7b3c-c622-11e3-bf01-24c6515278c0",14143,1,14143,0,0,"LIRI"
"de4f520c-c622-11e3-bf01-24c6515278c0",6037,2,4736,1301,0.21550439,"LIRI"
"df9f8c80-c622-11e3-bf01-24c6515278c0",1535,1,1535,0,0,"LIRI"
"e127e9e4-c622-11e3-bf01-24c6515278c0",13030,2,11966,1064,0.081657713,"LIRI"
"e23c591e-c622-11e3-bf01-24c6515278c0",9557,1,9557,0,0,"LIRI"
"e34bcc5e-c622-11e3-bf01-24c6515278c0",13459,2,12629,830,0.061668772,"LIRI"
"e4fd1b3e-c622-11e3-bf01-24c6515278c0",3198,2,2249,949,0.296747967,"LIRI"
"e64e9f76-c622-11e3-bf01-24c6515278c0",6399,2,6061,338,0.052820753,"LIRI"
"e75fbf08-c622-11e3-bf01-24c6515278c0",7240,2,6771,469,0.064779006,"LIRI"
"e88397a6-c622-11e3-bf01-24c6515278c0",4885,1,4885,0,0,"LIRI"
"e99ccc0c-c622-11e3-bf01-24c6515278c0",17417,2,15652,1765,0.101337773,"LIRI"
"eb588266-c622-11e3-bf01-24c6515278c0",17235,2,14934,2301,0.133507398,"LIRI"
"ec5e2990-c622-11e3-bf01-24c6515278c0",10062,1,10062,0,0,"LIRI"
"ed52e836-c622-11e3-bf01-24c6515278c0",3902,1,3902,0,0,"LIRI"
"ee7b8074-c622-11e3-bf01-24c6515278c0",8714,1,8714,0,0,"LIRI"
"ef78f09c-c622-11e3-bf01-24c6515278c0",9694,1,9694,0,0,"LIRI"
"f064f762-c622-11e3-bf01-24c6515278c0",11151,2,10448,703,0.063043673,"LIRI"
"f181848a-c622-11e3-bf01-24c6515278c0",7197,2,6808,389,0.054050299,"LIRI"
"f2b2111c-c622-11e3-bf01-24c6515278c0",16753,2,15865,888,0.053005432,"LIRI"
"f410b432-c622-11e3-bf01-24c6515278c0",11814,1,11814,0,0,"LIRI"
"f4f48342-c622-11e3-bf01-24c6515278c0",8083,2,7464,619,0.076580478,"LIRI"
"f61e794e-c622-11e3-bf01-24c6515278c0",10267,2,9650,617,0.060095451,"LIRI"
"f8733b80-c622-11e3-bf01-24c6515278c0",7749,2,7167,582,0.075106465,"LIRI"
"f9718c44-c622-11e3-bf01-24c6515278c0",11639,1,11639,0,0,"LIRI"
"fabf1f6c-c622-11e3-bf01-24c6515278c0",19846,1,19846,0,0,"LIRI"
"fbd899a0-c622-11e3-bf01-24c6515278c0",18423,2,16919,1504,0.081637084,"LIRI"
"fdf9a814-c622-11e3-bf01-24c6515278c0",5499,1,5499,0,0,"LIRI"
"ffad9288-c622-11e3-bf01-24c6515278c0",7361,2,6945,416,0.056514061,"LIRI"
