"samplename","num_total_snv","num_Clusters","num_clonal_snv","num_subclonal_snv","Subclonal_fraction","cancer_type"
"008aef39-0c97-48ce-9dfd-f12d67116c59",3102,3,2239,863,0.278207608,"PRAD"
"008bad10-d41b-4bbb-86fa-9976ecea46b1",2270,2,1486,784,0.345374449,"PRAD"
"0192d529-7340-45d8-a5f0-249cbb11ca19",2732,4,1652,1080,0.395314788,"PRAD"
"07531318-87e8-4db8-aa61-9b93597d063b",5034,1,5034,0,0,"PRAD"
"07f16397-71bb-4594-ad4d-caa7d2baeabd",2934,2,1418,1516,0.51670075,"PRAD"
"08e1d976-6c39-428e-a4c2-f655b675683e",2908,2,975,1933,0.664718019,"PRAD"
"0a6be23a-d5a0-4e95-ada2-a61b2b5d9485",3977,3,789,3188,0.801609253,"PRAD"
"0bfd1043-5142-3662-e050-11ac0c486501",6499,2,4639,1860,0.286197877,"PRAD"
"0bfd1043-70fb-d2dc-e050-11ac0c4860cb",5124,2,3680,1444,0.281811085,"PRAD"
"0bfd1043-7343-fdd0-e050-11ac0c484cab",9340,2,8593,747,0.079978587,"PRAD"
"0bfd1043-7344-fdd0-e050-11ac0c484cab",8213,2,7105,1108,0.134908073,"PRAD"
"0bfd1043-7346-fdd0-e050-11ac0c484cab",3600,2,3011,589,0.163611111,"PRAD"
"0bfd1043-7ebf-aaec-e050-11ac0c482f39",5296,2,4938,358,0.067598187,"PRAD"
"0bfd1043-7ec1-aaec-e050-11ac0c482f39",4444,2,3777,667,0.150090009,"PRAD"
"0bfd1043-7ed6-9ccc-e050-11ac0c481957",3601,2,3050,551,0.153013052,"PRAD"
"0bfd1043-816e-e3e4-e050-11ac0c4860c5",8419,2,6465,1954,0.232094073,"PRAD"
"0bfd1043-8170-e3e4-e050-11ac0c4860c5",6106,3,4551,1555,0.25466754,"PRAD"
"0bfd1043-8172-e3e4-e050-11ac0c4860c5",5738,2,5181,557,0.097072151,"PRAD"
"0bfd1043-8173-e3e4-e050-11ac0c4860c5",6161,4,4618,1543,0.250446356,"PRAD"
"0bfd1043-8175-e3e4-e050-11ac0c4860c5",6153,3,5202,951,0.154558752,"PRAD"
"0bfd1043-8177-e3e4-e050-11ac0c4860c5",3790,3,2582,1208,0.318733509,"PRAD"
"0bfd1043-817c-e3e4-e050-11ac0c4860c5",4456,3,3540,916,0.20556553,"PRAD"
"0bfd1043-817e-e3e4-e050-11ac0c4860c5",16650,3,14567,2083,0.125105105,"PRAD"
"0bfd1043-8180-e3e4-e050-11ac0c4860c5",11640,2,11025,615,0.052835052,"PRAD"
"0bfd1043-8181-e3e4-e050-11ac0c4860c5",12021,2,10893,1128,0.093835787,"PRAD"
"0bfd1043-8183-e3e4-e050-11ac0c4860c5",16812,3,14328,2484,0.147751606,"PRAD"
"0bfd1043-8187-e3e4-e050-11ac0c4860c5",7994,4,5458,2536,0.317237928,"PRAD"
"0bfd1043-8189-e3e4-e050-11ac0c4860c5",6230,2,4152,2078,0.333547352,"PRAD"
"0bfd1068-3fc3-a95b-e050-11ac0c4860c3",6821,3,4762,2059,0.301861897,"PRAD"
"0bfd1068-3fc5-a95b-e050-11ac0c4860c3",4398,3,2429,1969,0.447703502,"PRAD"
"0bfd1068-3fca-a95b-e050-11ac0c4860c3",3529,2,3276,253,0.071691697,"PRAD"
"0bfd1068-3fcd-a95b-e050-11ac0c4860c3",3730,2,3295,435,0.116621984,"PRAD"
"0bfd1068-3fcf-a95b-e050-11ac0c4860c3",5212,3,2872,2340,0.448963929,"PRAD"
"0bfd1068-3fd3-a95b-e050-11ac0c4860c3",6576,1,6576,0,0,"PRAD"
"0bfd1068-3fd5-a95b-e050-11ac0c4860c3",4297,3,3749,548,0.127530835,"PRAD"
"0bfd1068-3fd8-a95b-e050-11ac0c4860c3",5614,2,5274,340,0.060562879,"PRAD"
"0bfd1068-3fdd-a95b-e050-11ac0c4860c3",5495,2,4870,625,0.113739763,"PRAD"
"0bfd1068-3fdf-a95b-e050-11ac0c4860c3",11590,2,10837,753,0.064969802,"PRAD"
"0bfd1068-3fe1-a95b-e050-11ac0c4860c3",12471,3,9524,2947,0.236308235,"PRAD"
"0bfd1068-3fe4-a95b-e050-11ac0c4860c3",6056,3,4810,1246,0.205746367,"PRAD"
"0bfd1068-3fe6-a95b-e050-11ac0c4860c3",7005,2,6518,487,0.06952177,"PRAD"
"0bfe2ac9-0aec-c248-e050-11ac0d487e1c",3969,2,3128,841,0.211892164,"PRAD"
"0bfe2ac9-0aee-c248-e050-11ac0d487e1c",3947,2,2697,1250,0.316696225,"PRAD"
"0bfe2ac9-0af3-c248-e050-11ac0d487e1c",16993,3,13497,3496,0.205731772,"PRAD"
"0bfe2ac9-0af5-c248-e050-11ac0d487e1c",5639,2,4986,653,0.115800674,"PRAD"
"0bfe2ac9-0af8-c248-e050-11ac0d487e1c",5488,2,5048,440,0.080174927,"PRAD"
"0bfe2ac9-0afa-c248-e050-11ac0d487e1c",5764,3,3826,1938,0.336224844,"PRAD"
"0bfe2ac9-0afd-c248-e050-11ac0d487e1c",6135,2,5223,912,0.148655257,"PRAD"
"0bfe2ac9-0aff-c248-e050-11ac0d487e1c",5974,2,3962,2012,0.336792769,"PRAD"
"0bfebf9f-c779-e57d-e050-11ac0d487827",5049,2,4570,479,0.094870271,"PRAD"
"0bfebf9f-c77d-e57d-e050-11ac0d487827",11592,2,10857,735,0.063405797,"PRAD"
"0bfebf9f-c77f-e57d-e050-11ac0d487827",4867,2,4513,354,0.072734744,"PRAD"
"0bfebf9f-c781-e57d-e050-11ac0d487827",5702,3,5067,635,0.111364434,"PRAD"
"0bfebf9f-c783-e57d-e050-11ac0d487827",5974,2,5196,778,0.130231001,"PRAD"
"0c0038ff-6cc4-b0b0-e050-11ac0d483d73",5825,3,5109,716,0.122918455,"PRAD"
"0c0038ff-6cc6-b0b0-e050-11ac0d483d73",5475,2,5077,398,0.072694064,"PRAD"
"0c0038ff-6cc8-b0b0-e050-11ac0d483d73",6227,2,3945,2282,0.366468604,"PRAD"
"0c9a5dbc-f7f3-43e7-83d1-77b9fb4b8b54",3152,2,2132,1020,0.323604061,"PRAD"
"0cb4356c-b5d6-4541-b048-ff6d4b3a5d26",4033,4,1551,2482,0.615422762,"PRAD"
"0ed2e2e1-2fe3-43eb-8cad-34f3f21a7169",2036,2,1377,659,0.32367387,"PRAD"
"108b67d4-5d66-46da-8675-6acae643b76f",2124,2,1609,515,0.242467043,"PRAD"
"120f01d1-8884-4aca-a1cb-36b207b2aa3a",3910,2,2834,1076,0.275191816,"PRAD"
"126ee433-d345-4cac-882a-c91831a24690",2528,2,2277,251,0.099287975,"PRAD"
"145f2b89-8878-4390-b0f6-f09b02fb138a",2605,2,1597,1008,0.386948177,"PRAD"
"186cacaf-4f20-4ad2-a07a-a7dc942a70b0",2510,2,1696,814,0.324302789,"PRAD"
"1a319682-f55e-4e0b-8476-48a0bea6c265",3380,3,1855,1525,0.451183432,"PRAD"
"1bbfe6f2-ad19-4d29-895b-973f5a91c707",3081,3,1907,1174,0.381045115,"PRAD"
"1d91f9c7-67ba-4606-9f0a-01ec6fc08262",2557,2,1943,614,0.240125147,"PRAD"
"1dd96495-5f83-4d36-96cf-b77cd0cbbfda",474,1,474,0,0,"PRAD"
"1eb37b28-fac2-477a-88b3-e04291a07926",4921,2,4288,633,0.128632392,"PRAD"
"1f5e70c1-c5de-49e7-941a-46e11a4f4416",5839,2,5096,743,0.127247816,"PRAD"
"25c002f7-e972-421a-b32d-7dd675d81931",269,2,22,247,0.918215613,"PRAD"
"289790a5-77bd-49a9-a1ec-478a8ecacd7f",3146,4,1656,1490,0.473617292,"PRAD"
"2c9c50ff-01d9-4703-931b-04119178706f",3449,2,2586,863,0.250217454,"PRAD"
"2ea2294d-fab9-43ae-a222-370487495b06",3779,2,3362,417,0.110346653,"PRAD"
"304c3e10-583c-421d-ab01-15c937d5014a",3102,2,1575,1527,0.492263056,"PRAD"
"306ef5bc-97d0-4312-ae0e-343c4e31d869",3396,3,2468,928,0.273262662,"PRAD"
"32d8c373-b5c8-420b-9808-8812b5501649",3388,2,2191,1197,0.353305785,"PRAD"
"35553150-e4ef-4539-b220-259f2d634bd7",3259,2,1962,1297,0.397974839,"PRAD"
"36962459-e81f-4b8c-a08d-df60ef3283a3",3469,2,1912,1557,0.448832517,"PRAD"
"39aee9fc-fa27-4b71-b9e8-43ff34bd3930",3149,3,1796,1353,0.42966021,"PRAD"
"3e86e68b-d083-4450-b056-4cd0f8d4a084",1580,2,141,1439,0.910759494,"PRAD"
"41027c0b-85af-4c78-bba0-0da63cd75fa9",3257,2,2342,915,0.280933374,"PRAD"
"42a548f0-d86a-4273-8bda-be0fe6a53b20",4972,2,2173,2799,0.562952534,"PRAD"
"43b675e0-22e0-42d6-a060-afc93e22ac95",3917,4,1284,2633,0.672198111,"PRAD"
"44083f54-0953-48e3-a704-11ad0988ad2e",4090,3,2280,1810,0.442542787,"PRAD"
"45d0ccb2-641f-4348-b3a8-61f4113cd85b",2112,2,1838,274,0.129734848,"PRAD"
"475bca00-9089-4f50-8638-4e5e8aca6dcd",1677,1,1677,0,0,"PRAD"
"48c33a30-557b-4ecf-8066-5b4b068b5e3a",2734,2,696,2038,0.745427944,"PRAD"
"4c5228b5-bf31-4abd-a47c-d088e16dba13",2907,2,1997,910,0.313037496,"PRAD"
"4d11d7da-1204-437e-87b1-e8337a67c9a8",3500,1,3500,0,0,"PRAD"
"4e596add-a7c5-4617-9649-b4ac6612e39c",396,1,396,0,0,"PRAD"
"4eac784b-084a-4106-9a76-2d9fbec57033",2833,3,1533,1300,0.458877515,"PRAD"
"551d5082-ab6a-4674-af0d-ce408f589949",3085,2,1918,1167,0.37828201,"PRAD"
"581be6cf-9778-49c3-9c77-1316eaa78929",984,1,984,0,0,"PRAD"
"597e4011-ea99-4356-b1d9-8cfe35db7c3b",1237,1,1237,0,0,"PRAD"
"59938f45-3e57-43d6-af3b-bb4968249e5a",3695,2,2629,1066,0.28849797,"PRAD"
"59c18694-8a43-41dd-a6f6-52a20bc8dd54",2714,2,1552,1162,0.428150332,"PRAD"
"5c8da06c-7964-4ad1-ac9e-d1b5507105d2",5261,2,2332,2929,0.556738263,"PRAD"
"5d6ad982-bb01-4233-b8fa-d129460eec79",3315,3,1851,1464,0.441628959,"PRAD"
"61973578-4c0d-4a3f-b9c4-f96ceab24629",2684,2,2183,501,0.186661699,"PRAD"
"61a48c69-4f7d-4dc6-aff7-88a6c33137df",4867,3,1672,3195,0.656461886,"PRAD"
"61d941f1-87df-43af-8a29-b6809c809275",2855,2,338,2517,0.881611208,"PRAD"
"6218f366-d5d2-4289-a95e-eeedfae7523a",6650,2,2289,4361,0.655789474,"PRAD"
"6947cd78-0a51-4949-8383-343f9122d953",1181,1,1181,0,0,"PRAD"
"69dbe6ef-f5de-4c1f-b2f2-963dcb6ccd3e",2425,2,1465,960,0.395876289,"PRAD"
"6d936ef9-b5df-44d3-831f-528bf8ddc131",3393,2,1019,2374,0.699675803,"PRAD"
"6f25ca85-4b4a-420f-b0cc-5a4f65a97da3",2591,2,1410,1181,0.455808568,"PRAD"
"7181dd10-1371-4cb6-9219-a9542c62b854",2136,3,1370,766,0.358614232,"PRAD"
"7303f9fe-88bb-48ba-b9b4-ebf9e4770c1c",1672,1,1672,0,0,"PRAD"
"734a8251-9ecc-47f5-835f-846b67693ca6",2436,3,1840,596,0.244663383,"PRAD"
"769e2ac9-a121-4b2a-a0fd-5f755b579811",2778,2,1622,1156,0.41612671,"PRAD"
"783579bd-e29d-457c-8236-1a80b557600c",3612,2,2406,1206,0.333887043,"PRAD"
"79914ce9-04d8-4b0d-9f16-2e528044966e",4118,2,2068,2050,0.497814473,"PRAD"
"7a95af21-ca7c-4596-9c83-66d11ca0c417",2762,2,433,2329,0.843229544,"PRAD"
"7ae9b843-488f-459c-8c0d-c81dcae57f99",7678,3,2384,5294,0.689502475,"PRAD"
"7dd2dc62-0eb4-4d45-86f1-e9e9377181ca",4850,3,3268,1582,0.326185567,"PRAD"
"7e4d570e-f26b-41fb-84c5-2a6f7d668bb5",3684,3,2156,1528,0.414766558,"PRAD"
"7fe96e71-436d-49d4-9e47-e104e1203568",2215,1,2215,0,0,"PRAD"
"8044a282-bc2c-47c6-8a85-53c3b5eeb08f",1852,1,1852,0,0,"PRAD"
"836ec5a5-e385-4236-83e7-2641ee35db7f",3155,2,2584,571,0.180982567,"PRAD"
"84ae4dd8-f661-46aa-9892-69742e2f3542",2810,2,1907,903,0.321352313,"PRAD"
"86874a67-aa86-45f1-be32-3b2722ebedec",3164,2,2405,759,0.23988622,"PRAD"
"8689b53c-8883-479c-85f6-d13b86272b5d",3204,2,1590,1614,0.503745318,"PRAD"
"87e1ffee-a8cd-4d75-937e-ed415cf43546",2773,2,2515,258,0.093040029,"PRAD"
"887616c5-06a7-4e83-948c-3546202349fb",2966,3,1563,1403,0.473027647,"PRAD"
"8a9359de-b0ad-4a2d-a543-e3b982697db9",405,1,405,0,0,"PRAD"
"8bbe4006-be0a-4cd5-91f6-529100d4f06e",2392,4,550,1842,0.77006689,"PRAD"
"8c0a7dfa-6ec3-4262-b718-c3605722df37",3163,2,1407,1756,0.555169143,"PRAD"
"8c850df7-d48e-4386-b3a5-cac5da865ea5",1788,2,1375,413,0.23098434,"PRAD"
"8e7fe8bb-6b3d-428f-a232-97e6042a0f39",2067,3,1648,419,0.20270924,"PRAD"
"90fd404b-f734-41ed-a601-0f30e43625fc",1943,2,1537,406,0.208955224,"PRAD"
"9689cb33-8ac9-4ee5-800d-3900769988af",78,2,29,49,0.628205128,"PRAD"
"982b58c4-02b3-4e7d-8af0-4b133d0c7e50",3202,1,3202,0,0,"PRAD"
"98f54445-b151-4aeb-b8cf-91d743ba066e",2833,4,1183,1650,0.582421461,"PRAD"
"9e272bea-9193-4c10-a802-f7e18b2937a3",3356,3,2584,772,0.230035757,"PRAD"
"9ed8f0b9-d615-44c4-9ec9-e07ecd744922",3351,2,2589,762,0.227394808,"PRAD"
"9f5e6063-d19e-4f56-b3f9-5c2260d3bfc9",349,2,33,316,0.905444126,"PRAD"
"a08ec059-7592-4698-bb45-25a9c3680c23",7808,3,2253,5555,0.711449795,"PRAD"
"a1af7c42-47af-435c-bb51-b932a3cd7b91",4577,2,2779,1798,0.392833734,"PRAD"
"a6045753-60bb-4e65-bc89-1ef0b47aab35",3039,2,2202,837,0.275419546,"PRAD"
"a6d8467e-88e3-4ea5-8583-61c5ab9747ae",2442,2,1612,830,0.33988534,"PRAD"
"a9ec7d9e-b179-4782-a589-43c7d1642be9",1064,2,836,228,0.214285714,"PRAD"
"ab318624-db9d-41d8-b7b8-34712434f28f",1950,1,1950,0,0,"PRAD"
"ab8a55ed-ff47-4cad-ad91-52b9dc25aca7",4593,2,1274,3319,0.72262138,"PRAD"
"acb9750e-7e17-4cef-bee1-5d710f9bf3a7",2816,2,1626,1190,0.422585227,"PRAD"
"b1f2442f-a973-47b4-9891-f028f0d44adc",2054,1,2054,0,0,"PRAD"
"b2ec0fd0-fbcf-4abc-ad80-4ae444e30b55",2510,1,2510,0,0,"PRAD"
"b33978c6-a855-4f9d-a0b0-d79453b9de41",11292,2,1416,9876,0.874601488,"PRAD"
"b33b7c8f-0b0d-4009-88a7-48e9d9cae6cb",3582,2,2441,1141,0.31853713,"PRAD"
"b41c63e8-bb85-4f83-9bc6-e611fd9ef075",4864,3,1707,3157,0.649054276,"PRAD"
"b68c5ec2-0875-4d77-b4b7-738d2b2f313c",211,1,211,0,0,"PRAD"
"bb02202f-d140-4bec-95ce-5c2b117a2167",2447,2,2322,125,0.051082959,"PRAD"
"bc9f105f-6d99-44ac-9871-67defd5e85cd",2735,2,2302,433,0.158318099,"PRAD"
"beafb7c6-ef39-478e-aa47-0f1ad39f95a3",2948,2,2550,398,0.135006784,"PRAD"
"c08f65a0-bf4c-462e-9d07-ad56b3adcac8",4685,3,1514,3171,0.676840982,"PRAD"
"c14b2c74-447b-4526-a6e9-415d2728c7ca",3227,2,1281,1946,0.603036876,"PRAD"
"c6a28615-1b92-4085-956e-eeedb2573c03",3714,2,2989,725,0.195207324,"PRAD"
"caf2e99d-8f1f-4043-b567-c3fe28dc33ac",5231,2,4735,496,0.094819346,"PRAD"
"cd0c3b1f-c73a-4991-8724-4e74381900cb",2253,2,1285,968,0.429649356,"PRAD"
"d0f4dd92-a63b-4766-8889-5327fca1bd91",3075,2,1876,1199,0.389918699,"PRAD"
"d1875ee6-6677-4117-a7a8-930ab5cde775",2475,2,1924,551,0.222626263,"PRAD"
"d277e679-9fdd-44cd-9f2c-f9927e44d721",2103,2,1229,874,0.415596767,"PRAD"
"d32f41fb-0744-4a62-81f6-0260c4920049",2042,1,2042,0,0,"PRAD"
"d709d214-02ee-46c1-a73a-e7074cb2623e",2291,2,1824,467,0.203841117,"PRAD"
"db198301-6c69-4d56-88d1-c650406423dd",1850,2,1279,571,0.308648649,"PRAD"
"dbfdb5c6-f52e-48f3-87e7-fb922df9e7a9",2566,2,1683,883,0.344115355,"PRAD"
"dc85552c-2488-48d9-9da1-67a380945b85",3371,2,2834,537,0.159299911,"PRAD"
"dcc938da-3e45-4c2f-ae0f-47817be04518",2826,2,1134,1692,0.598726115,"PRAD"
"dcf98acc-736b-4af6-bdca-a320a413165a",1866,1,1866,0,0,"PRAD"
"ddc422e4-87e2-4fc0-b56b-ddc2d6a92f58",3218,3,1050,2168,0.673710379,"PRAD"
"e1b169c3-44e0-43e5-9ee3-2df7a678a5ea",3923,2,2286,1637,0.417282692,"PRAD"
"e1fc4226-40ce-43b7-b92e-aa7cecd0cf4d",2988,4,590,2398,0.802543507,"PRAD"
"e41bc2ec-3e0b-4c37-806b-3f6f25c8c4db",15433,2,14553,880,0.05702067,"PRAD"
"ed7be9ae-e603-4731-8d91-a8285abaee33",2761,3,1461,1300,0.470843897,"PRAD"
"f0f2030e-17fd-4dd9-9104-899e59d72ed8",408,2,83,325,0.796568627,"PRAD"
"f1534b2a-5350-442c-bb9d-8c7142668d31",3040,3,788,2252,0.740789474,"PRAD"
"f5378545-17d4-4a64-a57e-f6c91ef4cb3a",8206,2,2969,5237,0.638191567,"PRAD"
"f54442d1-80fa-4678-ac94-c3ad03bc37fb",1295,2,1161,134,0.103474903,"PRAD"
"f640d377-98e9-41d3-8761-61eb33072c65",7052,3,1092,5960,0.845150312,"PRAD"
"f7cc504a-37c9-45f5-b50d-599c54dca157",3505,2,3186,319,0.091012839,"PRAD"
"f8a165b0-51df-413c-b7c6-c7fc80547db4",2090,2,1708,382,0.18277512,"PRAD"
"f9854144-d92c-46da-ac87-9d1fd7efe67d",1865,1,1865,0,0,"PRAD"
"f9c07ba7-152a-f624-e040-11ac0c484cd5",36,2,13,23,0.638888889,"PRAD"
"f9c0a08b-d1e5-4c18-e040-11ac0c4864df",2779,2,2455,324,0.116588701,"PRAD"
"f9c0a0d9-5af6-4476-e040-11ac0d4830d3",3853,2,2342,1511,0.392161952,"PRAD"
"f9c0a12c-2651-d9ea-e040-11ac0d483201",2555,3,1991,564,0.22074364,"PRAD"
"f9c1df10-25b8-c8ae-e040-11ac0d486375",4025,2,1738,2287,0.568198758,"PRAD"
"f9c23ce8-7f1c-9417-e040-11ac0d482562",4676,3,2261,2415,0.516467066,"PRAD"
"f9c23d09-74e4-07f9-e040-11ac0d482577",751,2,76,675,0.898801598,"PRAD"
"f9c26646-d2b0-cf30-e040-11ac0d483918",2974,1,2974,0,0,"PRAD"
"f9c39eb7-39a9-6626-e040-11ac0d4870c2",2721,2,2265,456,0.167585447,"PRAD"
"f9c3bc8e-dbc4-1ed0-e040-11ac0d4803a9",3315,2,2842,473,0.142684766,"PRAD"
"f9c3e4e3-1b95-b71a-e040-11ac0d4819e7",2549,2,1498,1051,0.412318556,"PRAD"
"f9c3eaad-a0d9-8bf8-e040-11ac0d481d8e",3960,3,3094,866,0.218686869,"PRAD"
"f9c4e06c-e8a6-613b-e040-11ac0d4828ba",1474,2,1177,297,0.201492537,"PRAD"
"f9c51617-3fcb-91c5-e040-11ac0d484abf",1986,2,1342,644,0.324269889,"PRAD"
"f9c52187-2e82-d58a-e040-11ac0d484fc4",4617,2,1488,3129,0.677712801,"PRAD"
"f9c52414-385d-8cc7-e040-11ac0d485037",2025,2,1737,288,0.142222222,"PRAD"
"f9c650e7-9053-78eb-e040-11ac0d4874bb",3222,2,2878,344,0.106765984,"PRAD"
"f9c65e3d-f3f7-dd5f-e040-11ac0d487b1f",1803,2,1307,496,0.27509706,"PRAD"
"f9c6f4ca-4bb8-26b4-e040-11ac0d485600",56,2,26,30,0.535714286,"PRAD"
"f9c70e38-dd99-3fe2-e040-11ac0d4862f2",4106,2,1843,2263,0.551144666,"PRAD"
"fc9d5fc6-546f-27b7-e040-11ac0d485f87",1134,2,740,394,0.347442681,"PRAD"
"fc9d5fc6-719b-0525-e040-11ac0d485f83",2945,2,1052,1893,0.64278438,"PRAD"
"fc9d5fc6-7f7d-1313-e040-11ac0d485f85",6177,2,5652,525,0.084992715,"PRAD"
"fc9d5fc7-a87b-c5e7-e040-11ac0c4850aa",1522,1,1522,0,0,"PRAD"
"fc9d704c-0cfb-0407-e040-11ac0d486980",3263,2,2351,912,0.279497395,"PRAD"
"fc9d93b6-77c6-8719-e040-11ac0d487dec",2754,3,728,2026,0.735657226,"PRAD"
"fc9d93b6-92e8-acb7-e040-11ac0d487dee",3401,2,2884,517,0.152014113,"PRAD"
"fc9f9295-01f6-a9e0-e040-11ac0d4845af",2617,2,2318,299,0.114252961,"PRAD"
"fc9f998b-cc72-f6ea-e040-11ac0c482425",2324,2,1387,937,0.403184165,"PRAD"
"fca04929-586a-0594-e040-11ac0c48099d",3811,2,3087,724,0.189976384,"PRAD"
"fca1c663-dec0-db39-e040-11ac0c486140",1002,1,1002,0,0,"PRAD"
"fca2d62f-2756-939e-e040-11ac0d4865e6",2171,2,606,1565,0.72086596,"PRAD"
"fe083d2d-d088-4ac1-825b-8c5bbfe974ac",515,2,489,26,0.050485437,"PRAD"
"ff870342-f0d6-4450-8f9c-344c046a0baf",2471,2,1782,689,0.27883448,"PRAD"
