"tcga_id","Total_number_SNVs","Number_of_clusters","Number_of_clonal_SNVs","Number_of_subclonal_SNVs","Total_number_SNVs_CDS","Number_subclonal_SNVs_CDS","Subclonal_fraction","sML","cancer_type"
"TCGA-2G-AAEX",28,3,18,10,24,7,0.357142857,0.291666667,"TGCT"
"TCGA-2G-AAF1",12,2,4,8,10,8,0.666666667,0.8,"TGCT"
"TCGA-2G-AAF4",11,2,5,6,9,4,0.545454545,0.444444444,"TGCT"
"TCGA-2G-AAF8",20,2,16,4,17,3,0.2,0.176470588,"TGCT"
"TCGA-2G-AAFE",56,1,56,0,45,0,0,0,"TGCT"
"TCGA-2G-AAFG",26,3,4,22,18,15,0.846153846,0.833333333,"TGCT"
"TCGA-2G-AAFH",26,3,20,6,22,5,0.230769231,0.227272727,"TGCT"
"TCGA-2G-AAFJ",27,4,11,16,23,14,0.592592593,0.608695652,"TGCT"
"TCGA-2G-AAFL",26,2,21,5,20,4,0.192307692,0.2,"TGCT"
"TCGA-2G-AAFN",17,5,6,11,14,9,0.647058824,0.642857143,"TGCT"
"TCGA-2G-AAFV",27,4,9,18,19,13,0.666666667,0.684210526,"TGCT"
"TCGA-2G-AAFY",14,2,12,2,12,2,0.142857143,0.166666667,"TGCT"
"TCGA-2G-AAFZ",34,3,23,11,28,10,0.323529412,0.357142857,"TGCT"
"TCGA-2G-AAG0",29,2,25,4,23,4,0.137931034,0.173913043,"TGCT"
"TCGA-2G-AAG5",23,4,6,17,21,15,0.739130435,0.714285714,"TGCT"
"TCGA-2G-AAG7",26,4,7,19,21,15,0.730769231,0.714285714,"TGCT"
"TCGA-2G-AAG9",21,1,21,0,19,0,0,0,"TGCT"
"TCGA-2G-AAGA",34,4,8,26,29,22,0.764705882,0.75862069,"TGCT"
"TCGA-2G-AAGC",21,3,10,11,17,9,0.523809524,0.529411765,"TGCT"
"TCGA-2G-AAGE",23,4,14,9,17,4,0.391304348,0.235294118,"TGCT"
"TCGA-2G-AAGF",15,5,5,10,13,9,0.666666667,0.692307692,"TGCT"
"TCGA-2G-AAGG",50,5,15,35,40,29,0.7,0.725,"TGCT"
"TCGA-2G-AAGI",40,2,13,27,33,22,0.675,0.666666667,"TGCT"
"TCGA-2G-AAGJ",28,2,20,8,19,6,0.285714286,0.315789474,"TGCT"
"TCGA-2G-AAGO",27,3,20,7,23,6,0.259259259,0.260869565,"TGCT"
"TCGA-2G-AAGS",11,6,4,7,10,7,0.636363636,0.7,"TGCT"
"TCGA-2G-AAGT",19,4,11,8,16,6,0.421052632,0.375,"TGCT"
"TCGA-2G-AAGW",31,3,11,20,27,18,0.64516129,0.666666667,"TGCT"
"TCGA-2G-AAGX",10,4,4,6,8,4,0.6,0.5,"TGCT"
"TCGA-2G-AAGY",27,4,6,21,18,14,0.777777778,0.777777778,"TGCT"
"TCGA-2G-AAH3",39,4,13,26,30,21,0.666666667,0.7,"TGCT"
"TCGA-2G-AAH4",22,2,18,4,17,4,0.181818182,0.235294118,"TGCT"
"TCGA-2G-AAHA",20,3,6,14,15,10,0.7,0.666666667,"TGCT"
"TCGA-2G-AAHG",14,5,8,6,12,5,0.428571429,0.416666667,"TGCT"
"TCGA-2G-AAHL",22,2,20,2,17,2,0.090909091,0.117647059,"TGCT"
"TCGA-2G-AAHN",18,1,18,0,17,0,0,0,"TGCT"
"TCGA-2G-AAHP",34,5,8,26,27,21,0.764705882,0.777777778,"TGCT"
"TCGA-2G-AAKD",17,3,8,9,15,8,0.529411765,0.533333333,"TGCT"
"TCGA-2G-AAKG",59,3,42,17,50,15,0.288135593,0.3,"TGCT"
"TCGA-2G-AAKL",26,3,21,5,20,3,0.192307692,0.15,"TGCT"
"TCGA-2G-AAKO",24,2,5,19,20,17,0.791666667,0.85,"TGCT"
"TCGA-2G-AAL5",28,4,11,17,22,13,0.607142857,0.590909091,"TGCT"
"TCGA-2G-AAL7",24,3,17,7,20,7,0.291666667,0.35,"TGCT"
"TCGA-2G-AALF",22,2,8,14,18,11,0.636363636,0.611111111,"TGCT"
"TCGA-2G-AALG",12,4,4,8,8,4,0.666666667,0.5,"TGCT"
"TCGA-2G-AALP",54,3,42,12,45,9,0.222222222,0.2,"TGCT"
"TCGA-2G-AALQ",17,6,6,11,15,10,0.647058824,0.666666667,"TGCT"
"TCGA-2G-AALR",50,5,10,40,42,34,0.8,0.80952381,"TGCT"
"TCGA-2G-AALS",14,2,12,2,10,1,0.142857143,0.1,"TGCT"
"TCGA-2G-AALT",10,5,4,6,6,3,0.6,0.5,"TGCT"
"TCGA-2G-AALW",30,3,25,5,26,3,0.166666667,0.115384615,"TGCT"
"TCGA-2G-AALX",10,4,4,6,9,5,0.6,0.555555556,"TGCT"
"TCGA-2G-AAM2",21,3,14,7,16,6,0.333333333,0.375,"TGCT"
"TCGA-2G-AAM3",27,4,7,20,23,18,0.740740741,0.782608696,"TGCT"
"TCGA-2G-AAM4",25,4,11,14,20,11,0.56,0.55,"TGCT"
"TCGA-2X-A9D6",14,2,5,9,11,6,0.642857143,0.545454545,"TGCT"
"TCGA-4K-AA1I",14,2,10,4,11,4,0.285714286,0.363636364,"TGCT"
"TCGA-4K-AAAL",21,2,17,4,17,2,0.19047619,0.117647059,"TGCT"
"TCGA-SB-A6J6",24,1,24,0,20,0,0,0,"TGCT"
"TCGA-SN-A6IS",14,4,10,4,10,4,0.285714286,0.4,"TGCT"
"TCGA-SN-A84W",20,2,15,5,18,5,0.25,0.277777778,"TGCT"
"TCGA-SN-A84X",23,2,21,2,21,1,0.086956522,0.047619048,"TGCT"
"TCGA-SO-A8JP",27,4,15,12,22,11,0.444444444,0.5,"TGCT"
"TCGA-VF-A8A8",50,2,27,23,37,17,0.46,0.459459459,"TGCT"
"TCGA-VF-A8AC",14,2,9,5,10,4,0.357142857,0.4,"TGCT"
"TCGA-VF-A8AD",25,2,21,4,14,2,0.16,0.142857143,"TGCT"
"TCGA-VF-A8AE",20,2,3,17,14,13,0.85,0.928571429,"TGCT"
"TCGA-WZ-A7V3",22,3,14,8,18,6,0.363636364,0.333333333,"TGCT"
"TCGA-WZ-A7V5",47,2,33,14,39,12,0.29787234,0.307692308,"TGCT"
"TCGA-X3-A8G4",36,2,33,3,31,2,0.083333333,0.064516129,"TGCT"
"TCGA-XE-A8H5",35,3,31,4,33,4,0.114285714,0.121212121,"TGCT"
"TCGA-XE-AANI",31,2,28,3,27,3,0.096774194,0.111111111,"TGCT"
"TCGA-XE-AANJ",21,2,15,6,18,5,0.285714286,0.277777778,"TGCT"
"TCGA-XE-AANR",19,3,13,6,15,4,0.315789474,0.266666667,"TGCT"
"TCGA-XE-AANV",14,2,12,2,13,2,0.142857143,0.153846154,"TGCT"
"TCGA-XE-AAO3",16,2,6,10,12,9,0.625,0.75,"TGCT"
"TCGA-XE-AAO4",43,1,43,0,35,0,0,0,"TGCT"
"TCGA-XE-AAO6",26,2,22,4,19,2,0.153846154,0.105263158,"TGCT"
"TCGA-XE-AAOB",15,3,11,4,13,4,0.266666667,0.307692308,"TGCT"
"TCGA-XE-AAOC",23,4,14,9,20,9,0.391304348,0.45,"TGCT"
"TCGA-XE-AAOF",25,3,7,18,21,15,0.72,0.714285714,"TGCT"
"TCGA-XE-AAOJ",23,2,21,2,19,2,0.086956522,0.105263158,"TGCT"
"TCGA-XY-A89B",37,3,22,15,32,12,0.405405405,0.375,"TGCT"
"TCGA-XY-A8S2",65,3,49,16,55,13,0.246153846,0.236363636,"TGCT"
"TCGA-XY-A9T9",13,2,6,7,12,6,0.538461538,0.5,"TGCT"
"TCGA-YU-A90P",14,4,4,10,11,9,0.714285714,0.818181818,"TGCT"
"TCGA-YU-A90W",29,2,24,5,21,3,0.172413793,0.142857143,"TGCT"
"TCGA-YU-A90Y",17,5,4,13,16,13,0.764705882,0.8125,"TGCT"
"TCGA-YU-A94D",20,4,6,14,14,9,0.7,0.642857143,"TGCT"
"TCGA-YU-A94I",55,4,39,16,44,10,0.290909091,0.227272727,"TGCT"
"TCGA-YU-AA4L",19,6,8,11,13,6,0.578947368,0.461538462,"TGCT"
"TCGA-YU-AA61",14,4,7,7,10,6,0.5,0.6,"TGCT"
"TCGA-ZM-AA05",33,2,12,21,25,17,0.636363636,0.68,"TGCT"
"TCGA-ZM-AA06",21,2,18,3,16,2,0.142857143,0.125,"TGCT"
"TCGA-ZM-AA0B",18,3,13,5,16,5,0.277777778,0.3125,"TGCT"
"TCGA-ZM-AA0E",11,2,8,3,7,3,0.272727273,0.428571429,"TGCT"
"TCGA-ZM-AA0N",23,2,18,5,18,3,0.217391304,0.166666667,"TGCT"
