"tcga_id","Total_number_SNVs","Number_of_clusters","Number_of_clonal_SNVs","Number_of_subclonal_SNVs","Total_number_SNVs_CDS","Number_subclonal_SNVs_CDS","Subclonal_fraction","sML","cancer_type"
"TCGA-4C-A93U",68,3,30,38,60,35,0.558823529,0.583333333,"THCA"
"TCGA-BJ-A0YZ",21,4,7,14,18,13,0.666666667,0.722222222,"THCA"
"TCGA-BJ-A0Z0",34,5,8,26,28,21,0.764705882,0.75,"THCA"
"TCGA-BJ-A0Z2",22,3,13,9,19,8,0.409090909,0.421052632,"THCA"
"TCGA-BJ-A0ZA",12,4,2,10,12,10,0.833333333,0.833333333,"THCA"
"TCGA-BJ-A0ZB",49,3,21,28,42,25,0.571428571,0.595238095,"THCA"
"TCGA-BJ-A0ZE",18,4,4,14,16,12,0.777777778,0.75,"THCA"
"TCGA-BJ-A0ZF",27,5,7,20,21,14,0.740740741,0.666666667,"THCA"
"TCGA-BJ-A0ZG",12,2,4,8,10,8,0.666666667,0.8,"THCA"
"TCGA-BJ-A0ZH",26,5,4,22,23,21,0.846153846,0.913043478,"THCA"
"TCGA-BJ-A18Z",23,4,4,19,21,18,0.826086957,0.857142857,"THCA"
"TCGA-BJ-A191",144,3,22,122,122,103,0.847222222,0.844262295,"THCA"
"TCGA-BJ-A28S",22,3,11,11,19,10,0.5,0.526315789,"THCA"
"TCGA-BJ-A28V",27,6,5,22,21,17,0.814814815,0.80952381,"THCA"
"TCGA-BJ-A28Z",31,2,27,4,26,3,0.129032258,0.115384615,"THCA"
"TCGA-BJ-A2N8",19,4,3,16,15,13,0.842105263,0.866666667,"THCA"
"TCGA-BJ-A2P4",16,4,6,10,16,10,0.625,0.625,"THCA"
"TCGA-BJ-A3EZ",24,4,5,19,23,18,0.791666667,0.782608696,"THCA"
"TCGA-BJ-A3PR",12,2,5,7,11,7,0.583333333,0.636363636,"THCA"
"TCGA-BJ-A3PT",15,3,3,12,15,12,0.8,0.8,"THCA"
"TCGA-BJ-A45D",15,3,4,11,12,9,0.733333333,0.75,"THCA"
"TCGA-BJ-A45H",11,4,2,9,9,7,0.818181818,0.777777778,"THCA"
"TCGA-CE-A13K",15,6,5,10,13,9,0.666666667,0.692307692,"THCA"
"TCGA-CE-A3MD",12,4,3,9,11,8,0.75,0.727272727,"THCA"
"TCGA-CE-A3ME",15,4,3,12,13,10,0.8,0.769230769,"THCA"
"TCGA-CE-A481",14,3,6,8,12,7,0.571428571,0.583333333,"THCA"
"TCGA-DE-A0XZ",27,4,13,14,22,11,0.518518519,0.5,"THCA"
"TCGA-DE-A0Y2",25,5,8,17,22,15,0.68,0.681818182,"THCA"
"TCGA-DE-A2OL",12,5,2,10,12,10,0.833333333,0.833333333,"THCA"
"TCGA-DE-A4M8",12,3,7,5,9,4,0.416666667,0.444444444,"THCA"
"TCGA-DE-A4M9",13,4,2,11,12,10,0.846153846,0.833333333,"THCA"
"TCGA-DE-A4MA",11,4,2,9,9,7,0.818181818,0.777777778,"THCA"
"TCGA-DE-A4MD",42,3,22,20,40,19,0.476190476,0.475,"THCA"
"TCGA-DE-A69K",19,5,4,15,14,10,0.789473684,0.714285714,"THCA"
"TCGA-DJ-A13L",42,3,12,30,38,26,0.714285714,0.684210526,"THCA"
"TCGA-DJ-A13R",15,4,8,7,14,7,0.466666667,0.5,"THCA"
"TCGA-DJ-A13S",14,3,7,7,13,6,0.5,0.461538462,"THCA"
"TCGA-DJ-A13V",11,5,2,9,9,7,0.818181818,0.777777778,"THCA"
"TCGA-DJ-A13W",13,5,3,10,11,9,0.769230769,0.818181818,"THCA"
"TCGA-DJ-A13X",14,4,4,10,14,10,0.714285714,0.714285714,"THCA"
"TCGA-DJ-A1QE",17,5,4,13,17,13,0.764705882,0.764705882,"THCA"
"TCGA-DJ-A1QF",16,4,3,13,15,12,0.8125,0.8,"THCA"
"TCGA-DJ-A1QG",20,3,7,13,19,12,0.65,0.631578947,"THCA"
"TCGA-DJ-A1QI",12,4,3,9,10,7,0.75,0.7,"THCA"
"TCGA-DJ-A1QL",20,3,13,7,17,6,0.35,0.352941176,"THCA"
"TCGA-DJ-A1QM",13,2,11,2,12,2,0.153846154,0.166666667,"THCA"
"TCGA-DJ-A1QO",18,5,7,11,16,11,0.611111111,0.6875,"THCA"
"TCGA-DJ-A2PP",22,3,12,10,17,8,0.454545455,0.470588235,"THCA"
"TCGA-DJ-A2PT",14,4,3,11,13,10,0.785714286,0.769230769,"THCA"
"TCGA-DJ-A2PV",10,3,3,7,9,6,0.7,0.666666667,"THCA"
"TCGA-DJ-A2PW",24,3,4,20,21,18,0.833333333,0.857142857,"THCA"
"TCGA-DJ-A2PX",118,2,7,111,101,95,0.940677966,0.940594059,"THCA"
"TCGA-DJ-A2PY",13,5,3,10,10,9,0.769230769,0.9,"THCA"
"TCGA-DJ-A2PZ",20,3,11,9,20,9,0.45,0.45,"THCA"
"TCGA-DJ-A2Q1",22,4,5,17,18,15,0.772727273,0.833333333,"THCA"
"TCGA-DJ-A2Q3",21,4,4,17,19,15,0.80952381,0.789473684,"THCA"
"TCGA-DJ-A2Q4",19,5,6,13,18,12,0.684210526,0.666666667,"THCA"
"TCGA-DJ-A2Q7",19,4,5,14,18,13,0.736842105,0.722222222,"THCA"
"TCGA-DJ-A2Q8",10,4,2,8,9,7,0.8,0.777777778,"THCA"
"TCGA-DJ-A2Q9",17,2,2,15,17,15,0.882352941,0.882352941,"THCA"
"TCGA-DJ-A2QA",17,4,3,14,15,13,0.823529412,0.866666667,"THCA"
"TCGA-DJ-A2QB",686,2,42,644,618,581,0.93877551,0.94012945,"THCA"
"TCGA-DJ-A3UQ",10,3,3,7,9,6,0.7,0.666666667,"THCA"
"TCGA-DJ-A3UV",11,3,4,7,10,7,0.636363636,0.7,"THCA"
"TCGA-DJ-A3V0",23,3,16,7,18,6,0.304347826,0.333333333,"THCA"
"TCGA-DJ-A3V4",16,6,3,13,14,12,0.8125,0.857142857,"THCA"
"TCGA-DJ-A3V5",21,3,14,7,17,5,0.333333333,0.294117647,"THCA"
"TCGA-DJ-A3V7",33,5,6,27,30,24,0.818181818,0.8,"THCA"
"TCGA-DJ-A3V8",13,4,3,10,13,10,0.769230769,0.769230769,"THCA"
"TCGA-DJ-A3VA",15,5,3,12,12,9,0.8,0.75,"THCA"
"TCGA-DJ-A3VE",13,5,2,11,13,11,0.846153846,0.846153846,"THCA"
"TCGA-DJ-A3VG",19,4,3,16,16,15,0.842105263,0.9375,"THCA"
"TCGA-DJ-A3VI",23,5,6,17,22,16,0.739130435,0.727272727,"THCA"
"TCGA-DJ-A3VL",12,4,3,9,6,5,0.75,0.833333333,"THCA"
"TCGA-DJ-A4UQ",19,5,3,16,18,15,0.842105263,0.833333333,"THCA"
"TCGA-DJ-A4UR",17,5,4,13,14,11,0.764705882,0.785714286,"THCA"
"TCGA-DJ-A4UT",40,3,6,34,33,29,0.85,0.878787879,"THCA"
"TCGA-DJ-A4UW",10,4,5,5,8,3,0.5,0.375,"THCA"
"TCGA-DJ-A4V2",11,6,2,9,9,7,0.818181818,0.777777778,"THCA"
"TCGA-DJ-A4V4",27,3,5,22,26,21,0.814814815,0.807692308,"THCA"
"TCGA-DO-A1K0",10,3,4,6,8,4,0.6,0.5,"THCA"
"TCGA-DO-A2HM",95,2,9,86,82,76,0.905263158,0.926829268,"THCA"
"TCGA-E3-A3DY",10,3,2,8,10,8,0.8,0.8,"THCA"
"TCGA-E3-A3E0",10,3,7,3,8,1,0.3,0.125,"THCA"
"TCGA-E3-A3E1",11,3,2,9,11,9,0.818181818,0.818181818,"THCA"
"TCGA-E3-A3E3",13,5,3,10,8,8,0.769230769,1,"THCA"
"TCGA-E8-A242",17,3,3,14,15,12,0.823529412,0.8,"THCA"
"TCGA-E8-A2EA",459,2,23,436,392,375,0.949891068,0.956632653,"THCA"
"TCGA-E8-A415",10,3,2,8,9,8,0.8,0.888888889,"THCA"
"TCGA-E8-A417",28,3,5,23,27,22,0.821428571,0.814814815,"THCA"
"TCGA-E8-A418",40,5,6,34,35,31,0.85,0.885714286,"THCA"
"TCGA-E8-A419",11,3,2,9,9,8,0.818181818,0.888888889,"THCA"
"TCGA-E8-A432",25,2,22,3,22,2,0.12,0.090909091,"THCA"
"TCGA-E8-A433",11,3,6,5,11,5,0.454545455,0.454545455,"THCA"
"TCGA-E8-A44K",13,5,3,10,11,9,0.769230769,0.818181818,"THCA"
"TCGA-EL-A3CM",28,3,6,22,25,20,0.785714286,0.8,"THCA"
"TCGA-EL-A3CN",19,4,8,11,17,11,0.578947368,0.647058824,"THCA"
"TCGA-EL-A3CP",11,3,2,9,9,7,0.818181818,0.777777778,"THCA"
"TCGA-EL-A3CR",34,3,10,24,32,23,0.705882353,0.71875,"THCA"
"TCGA-EL-A3CS",25,5,9,16,22,15,0.64,0.681818182,"THCA"
"TCGA-EL-A3D0",25,4,6,19,24,18,0.76,0.75,"THCA"
"TCGA-EL-A3D5",10,5,4,6,8,4,0.6,0.5,"THCA"
"TCGA-EL-A3D6",32,5,5,27,26,23,0.84375,0.884615385,"THCA"
"TCGA-EL-A3GP",26,2,20,6,20,3,0.230769231,0.15,"THCA"
"TCGA-EL-A3GQ",15,5,10,5,15,5,0.333333333,0.333333333,"THCA"
"TCGA-EL-A3GR",13,4,3,10,10,8,0.769230769,0.8,"THCA"
"TCGA-EL-A3GS",13,6,3,10,10,8,0.769230769,0.8,"THCA"
"TCGA-EL-A3GU",23,3,15,8,22,8,0.347826087,0.363636364,"THCA"
"TCGA-EL-A3GV",20,2,3,17,16,15,0.85,0.9375,"THCA"
"TCGA-EL-A3GX",12,4,5,7,9,6,0.583333333,0.666666667,"THCA"
"TCGA-EL-A3GY",14,3,3,11,14,11,0.785714286,0.785714286,"THCA"
"TCGA-EL-A3GZ",11,5,3,8,10,7,0.727272727,0.7,"THCA"
"TCGA-EL-A3H1",24,4,13,11,21,10,0.458333333,0.476190476,"THCA"
"TCGA-EL-A3H4",14,4,3,11,13,11,0.785714286,0.846153846,"THCA"
"TCGA-EL-A3H7",21,4,4,17,20,16,0.80952381,0.8,"THCA"
"TCGA-EL-A3MW",10,3,4,6,9,5,0.6,0.555555556,"THCA"
"TCGA-EL-A3MY",22,4,6,16,20,15,0.727272727,0.75,"THCA"
"TCGA-EL-A3MZ",30,6,6,24,26,22,0.8,0.846153846,"THCA"
"TCGA-EL-A3T0",17,3,3,14,16,13,0.823529412,0.8125,"THCA"
"TCGA-EL-A3T1",16,4,6,10,15,9,0.625,0.6,"THCA"
"TCGA-EL-A3T2",22,3,4,18,17,15,0.818181818,0.882352941,"THCA"
"TCGA-EL-A3T3",22,3,5,17,20,16,0.772727273,0.8,"THCA"
"TCGA-EL-A3T6",10,4,2,8,6,5,0.8,0.833333333,"THCA"
"TCGA-EL-A3T8",10,3,2,8,10,8,0.8,0.8,"THCA"
"TCGA-EL-A3T9",27,2,25,2,26,2,0.074074074,0.076923077,"THCA"
"TCGA-EL-A3TB",19,5,3,16,19,16,0.842105263,0.842105263,"THCA"
"TCGA-EL-A3ZK",11,4,4,7,11,7,0.636363636,0.636363636,"THCA"
"TCGA-EL-A3ZL",16,4,13,3,14,3,0.1875,0.214285714,"THCA"
"TCGA-EL-A3ZO",111,2,31,80,92,69,0.720720721,0.75,"THCA"
"TCGA-EL-A3ZQ",12,5,3,9,9,7,0.75,0.777777778,"THCA"
"TCGA-EL-A3ZR",19,5,5,14,15,11,0.736842105,0.733333333,"THCA"
"TCGA-EL-A3ZT",14,5,3,11,12,9,0.785714286,0.75,"THCA"
"TCGA-EL-A4JV",12,3,3,9,11,8,0.75,0.727272727,"THCA"
"TCGA-EL-A4JZ",12,4,9,3,11,3,0.25,0.272727273,"THCA"
"TCGA-EL-A4K0",11,4,4,7,11,7,0.636363636,0.636363636,"THCA"
"TCGA-EL-A4K2",13,5,2,11,10,9,0.846153846,0.9,"THCA"
"TCGA-EL-A4K4",11,5,2,9,11,9,0.818181818,0.818181818,"THCA"
"TCGA-EL-A4K7",48,2,8,40,45,39,0.833333333,0.866666667,"THCA"
"TCGA-EL-A4KG",57,2,9,48,52,43,0.842105263,0.826923077,"THCA"
"TCGA-EL-A4KI",21,4,8,13,19,12,0.619047619,0.631578947,"THCA"
"TCGA-EM-A1YA",14,4,3,11,10,8,0.785714286,0.8,"THCA"
"TCGA-EM-A1YE",11,3,6,5,11,5,0.454545455,0.454545455,"THCA"
"TCGA-EM-A22I",11,5,2,9,10,8,0.818181818,0.8,"THCA"
"TCGA-EM-A22J",176,2,33,143,153,125,0.8125,0.816993464,"THCA"
"TCGA-EM-A22K",17,4,4,13,14,10,0.764705882,0.714285714,"THCA"
"TCGA-EM-A22L",30,2,7,23,27,21,0.766666667,0.777777778,"THCA"
"TCGA-EM-A22M",112,2,6,106,99,94,0.946428571,0.949494949,"THCA"
"TCGA-EM-A22O",40,3,19,21,38,21,0.525,0.552631579,"THCA"
"TCGA-EM-A22P",16,2,12,4,14,3,0.25,0.214285714,"THCA"
"TCGA-EM-A2CJ",75,2,5,70,68,64,0.933333333,0.941176471,"THCA"
"TCGA-EM-A2CK",22,3,4,18,19,15,0.818181818,0.789473684,"THCA"
"TCGA-EM-A2CM",38,4,22,16,33,14,0.421052632,0.424242424,"THCA"
"TCGA-EM-A2CN",214,2,14,200,174,163,0.934579439,0.936781609,"THCA"
"TCGA-EM-A2CO",16,4,5,11,16,11,0.6875,0.6875,"THCA"
"TCGA-EM-A2CU",23,2,6,17,22,16,0.739130435,0.727272727,"THCA"
"TCGA-EM-A2OV",16,3,7,9,15,8,0.5625,0.533333333,"THCA"
"TCGA-EM-A2OW",18,5,6,12,15,11,0.666666667,0.733333333,"THCA"
"TCGA-EM-A2OY",16,3,11,5,13,4,0.3125,0.307692308,"THCA"
"TCGA-EM-A2OZ",61,2,6,55,51,45,0.901639344,0.882352941,"THCA"
"TCGA-EM-A2P1",20,4,4,16,16,13,0.8,0.8125,"THCA"
"TCGA-EM-A2P2",20,5,11,9,19,9,0.45,0.473684211,"THCA"
"TCGA-EM-A2P3",13,5,2,11,12,10,0.846153846,0.833333333,"THCA"
"TCGA-EM-A3AK",13,3,3,10,12,9,0.769230769,0.75,"THCA"
"TCGA-EM-A3AL",15,4,6,9,15,9,0.6,0.6,"THCA"
"TCGA-EM-A3AO",10,4,6,4,9,4,0.4,0.444444444,"THCA"
"TCGA-EM-A3AQ",12,3,4,8,12,8,0.666666667,0.666666667,"THCA"
"TCGA-EM-A3FK",11,5,3,8,9,6,0.727272727,0.666666667,"THCA"
"TCGA-EM-A3FL",12,3,5,7,12,7,0.583333333,0.583333333,"THCA"
"TCGA-EM-A3FM",20,5,3,17,16,14,0.85,0.875,"THCA"
"TCGA-EM-A3FN",22,5,5,17,18,15,0.772727273,0.833333333,"THCA"
"TCGA-EM-A3FP",15,4,9,6,14,6,0.4,0.428571429,"THCA"
"TCGA-EM-A3FQ",14,3,3,11,11,9,0.785714286,0.818181818,"THCA"
"TCGA-EM-A3FR",16,6,4,12,14,10,0.75,0.714285714,"THCA"
"TCGA-EM-A3O3",41,3,31,10,36,9,0.243902439,0.25,"THCA"
"TCGA-EM-A3O6",13,6,3,10,11,9,0.769230769,0.818181818,"THCA"
"TCGA-EM-A3O7",13,3,4,9,11,7,0.692307692,0.636363636,"THCA"
"TCGA-EM-A3O8",11,6,2,9,5,3,0.818181818,0.6,"THCA"
"TCGA-EM-A3O9",11,4,2,9,11,9,0.818181818,0.818181818,"THCA"
"TCGA-EM-A3ST",23,3,11,12,19,12,0.52173913,0.631578947,"THCA"
"TCGA-EM-A4FK",11,4,5,6,11,6,0.545454545,0.545454545,"THCA"
"TCGA-EM-A4FM",25,5,5,20,25,20,0.8,0.8,"THCA"
"TCGA-EM-A4FN",16,5,5,11,16,11,0.6875,0.6875,"THCA"
"TCGA-EM-A4FO",17,3,4,13,15,11,0.764705882,0.733333333,"THCA"
"TCGA-EM-A4FV",27,4,7,20,26,19,0.740740741,0.730769231,"THCA"
"TCGA-ET-A25G",21,4,12,9,13,6,0.428571429,0.461538462,"THCA"
"TCGA-ET-A25I",16,4,3,13,14,11,0.8125,0.785714286,"THCA"
"TCGA-ET-A25J",15,4,6,9,12,7,0.6,0.583333333,"THCA"
"TCGA-ET-A25K",21,2,4,17,19,15,0.80952381,0.789473684,"THCA"
"TCGA-ET-A25O",23,4,4,19,17,13,0.826086957,0.764705882,"THCA"
"TCGA-ET-A25R",16,4,3,13,16,13,0.8125,0.8125,"THCA"
"TCGA-ET-A2MX",13,6,4,9,11,8,0.692307692,0.727272727,"THCA"
"TCGA-ET-A2MY",70,3,11,59,66,55,0.842857143,0.833333333,"THCA"
"TCGA-ET-A2N0",13,4,3,10,13,10,0.769230769,0.769230769,"THCA"
"TCGA-ET-A2N1",19,4,3,16,19,16,0.842105263,0.842105263,"THCA"
"TCGA-ET-A2N3",10,5,3,7,7,6,0.7,0.857142857,"THCA"
"TCGA-ET-A2N4",21,4,7,14,20,13,0.666666667,0.65,"THCA"
"TCGA-ET-A2N5",10,4,5,5,10,5,0.5,0.5,"THCA"
"TCGA-ET-A39I",13,4,6,7,11,5,0.538461538,0.454545455,"THCA"
"TCGA-ET-A39P",95,2,23,72,79,61,0.757894737,0.772151899,"THCA"
"TCGA-ET-A3BN",11,4,3,8,9,8,0.727272727,0.888888889,"THCA"
"TCGA-ET-A3BQ",17,5,3,14,17,14,0.823529412,0.823529412,"THCA"
"TCGA-ET-A3BV",28,4,5,23,27,23,0.821428571,0.851851852,"THCA"
"TCGA-ET-A3BW",13,4,5,8,11,8,0.615384615,0.727272727,"THCA"
"TCGA-ET-A3BX",12,6,2,10,8,6,0.833333333,0.75,"THCA"
"TCGA-ET-A3DO",13,5,2,11,12,11,0.846153846,0.916666667,"THCA"
"TCGA-ET-A3DP",22,3,4,18,21,17,0.818181818,0.80952381,"THCA"
"TCGA-ET-A3DR",17,4,3,14,14,12,0.823529412,0.857142857,"THCA"
"TCGA-ET-A3DU",19,4,3,16,17,15,0.842105263,0.882352941,"THCA"
"TCGA-ET-A3DW",23,3,6,17,20,16,0.739130435,0.8,"THCA"
"TCGA-ET-A40Q",16,4,4,12,12,9,0.75,0.75,"THCA"
"TCGA-ET-A40S",14,5,6,8,11,6,0.571428571,0.545454545,"THCA"
"TCGA-ET-A40T",21,3,12,9,14,8,0.428571429,0.571428571,"THCA"
"TCGA-ET-A4KQ",10,3,2,8,9,8,0.8,0.888888889,"THCA"
"TCGA-FE-A22Z",23,3,17,6,17,6,0.260869565,0.352941176,"THCA"
"TCGA-FE-A231",19,4,11,8,16,8,0.421052632,0.5,"THCA"
"TCGA-FE-A232",15,5,3,12,15,12,0.8,0.8,"THCA"
"TCGA-FE-A233",14,4,3,11,11,8,0.785714286,0.727272727,"THCA"
"TCGA-FE-A234",12,5,2,10,9,7,0.833333333,0.777777778,"THCA"
"TCGA-FE-A236",14,4,4,10,10,7,0.714285714,0.7,"THCA"
"TCGA-FE-A237",30,2,2,28,24,23,0.933333333,0.958333333,"THCA"
"TCGA-FE-A23A",13,4,2,11,9,7,0.846153846,0.777777778,"THCA"
"TCGA-FE-A3PC",25,4,5,20,23,19,0.8,0.826086957,"THCA"
"TCGA-FE-A3PD",11,3,4,7,9,5,0.636363636,0.555555556,"THCA"
"TCGA-FK-A3S3",11,4,2,9,9,7,0.818181818,0.777777778,"THCA"
"TCGA-FK-A3SD",22,4,4,18,19,15,0.818181818,0.789473684,"THCA"
"TCGA-FK-A3SH",16,4,3,13,15,12,0.8125,0.8,"THCA"
"TCGA-FY-A2QD",16,3,3,13,14,11,0.8125,0.785714286,"THCA"
"TCGA-FY-A3BL",392,2,26,366,342,319,0.933673469,0.932748538,"THCA"
"TCGA-FY-A3I5",16,5,5,11,13,8,0.6875,0.615384615,"THCA"
"TCGA-FY-A3NN",14,4,3,11,12,9,0.785714286,0.75,"THCA"
"TCGA-FY-A3NP",15,4,3,12,13,10,0.8,0.769230769,"THCA"
"TCGA-FY-A3R6",10,3,2,8,10,8,0.8,0.8,"THCA"
"TCGA-FY-A3R9",26,4,4,22,19,17,0.846153846,0.894736842,"THCA"
"TCGA-FY-A40M",15,5,7,8,14,7,0.533333333,0.5,"THCA"
"TCGA-FY-A4B3",14,4,4,10,13,10,0.714285714,0.769230769,"THCA"
"TCGA-FY-A4B4",16,5,3,13,15,13,0.8125,0.866666667,"THCA"
"TCGA-FY-A76V",13,5,2,11,11,9,0.846153846,0.818181818,"THCA"
"TCGA-H2-A3RH",18,2,7,11,16,10,0.611111111,0.625,"THCA"
"TCGA-H2-A421",30,4,5,25,25,23,0.833333333,0.92,"THCA"
"TCGA-H2-A422",15,4,7,8,14,7,0.533333333,0.5,"THCA"
"TCGA-IM-A3ED",11,4,2,9,10,8,0.818181818,0.8,"THCA"
"TCGA-IM-A3U2",42,5,10,32,35,28,0.761904762,0.8,"THCA"
"TCGA-IM-A3U3",19,4,3,16,18,15,0.842105263,0.833333333,"THCA"
"TCGA-IM-A41Y",33,5,6,27,31,25,0.818181818,0.806451613,"THCA"
"TCGA-IM-A4EB",14,5,3,11,14,11,0.785714286,0.785714286,"THCA"
"TCGA-J8-A3NZ",12,6,2,10,10,8,0.833333333,0.8,"THCA"
"TCGA-J8-A3O1",25,5,7,18,20,15,0.72,0.75,"THCA"
"TCGA-J8-A3O2",19,5,3,16,17,14,0.842105263,0.823529412,"THCA"
"TCGA-J8-A3YD",13,2,2,11,10,9,0.846153846,0.9,"THCA"
"TCGA-J8-A3YF",30,4,5,25,28,23,0.833333333,0.821428571,"THCA"
"TCGA-J8-A42S",14,4,3,11,14,11,0.785714286,0.785714286,"THCA"
"TCGA-KS-A41I",10,5,4,6,10,6,0.6,0.6,"THCA"
"TCGA-KS-A41J",13,5,4,9,12,8,0.692307692,0.666666667,"THCA"
"TCGA-KS-A41L",10,4,2,8,10,8,0.8,0.8,"THCA"
"TCGA-KS-A4I1",10,4,4,6,9,5,0.6,0.555555556,"THCA"
"TCGA-KS-A4I3",13,3,6,7,11,6,0.538461538,0.545454545,"THCA"
"TCGA-KS-A4I5",15,5,3,12,14,11,0.8,0.785714286,"THCA"
"TCGA-KS-A4I9",11,5,4,7,9,6,0.636363636,0.666666667,"THCA"
"TCGA-KS-A4ID",16,4,4,12,14,11,0.75,0.785714286,"THCA"
"TCGA-L6-A4EQ",19,3,12,7,18,6,0.368421053,0.333333333,"THCA"
"TCGA-L6-A4ET",11,3,2,9,11,9,0.818181818,0.818181818,"THCA"
"TCGA-MK-A4N6",12,5,2,10,10,8,0.833333333,0.8,"THCA"
"TCGA-MK-A4N7",18,4,3,15,18,15,0.833333333,0.833333333,"THCA"
"TCGA-MK-A84Z",20,2,18,2,19,2,0.1,0.105263158,"THCA"
"TCGA-QD-A8IV",10,3,8,2,10,2,0.2,0.2,"THCA"
"TCGA-BJ-A28R",12,4,3,9,11,9,0.75,0.818181818,"THCA"
"TCGA-BJ-A290",61,4,15,46,51,40,0.754098361,0.784313725,"THCA"
"TCGA-BJ-A2NA",49,4,8,41,43,37,0.836734694,0.860465116,"THCA"
"TCGA-BJ-A45F",11,5,2,9,11,9,0.818181818,0.818181818,"THCA"
"TCGA-BJ-A45G",15,3,3,12,15,12,0.8,0.8,"THCA"
"TCGA-BJ-A45I",15,2,3,12,14,11,0.8,0.785714286,"THCA"
"TCGA-BJ-A45J",19,2,1,18,17,16,0.947368421,0.941176471,"THCA"
"TCGA-BJ-A4O9",24,3,16,8,19,5,0.333333333,0.263157895,"THCA"
"TCGA-E8-A2JQ",18,2,3,15,17,15,0.833333333,0.882352941,"THCA"
"TCGA-EM-A1CT",25,3,18,7,23,6,0.28,0.260869565,"THCA"
"TCGA-EM-A1CU",15,5,4,11,14,10,0.733333333,0.714285714,"THCA"
"TCGA-EM-A2CS",14,5,3,11,12,9,0.785714286,0.75,"THCA"
"TCGA-EM-A3SU",14,3,4,10,14,10,0.714285714,0.714285714,"THCA"
"TCGA-H2-A2K9",31,3,6,25,28,22,0.806451613,0.785714286,"THCA"
"TCGA-J8-A4HW",14,5,6,8,14,8,0.571428571,0.571428571,"THCA"
